...8.49.3
.8163...5
.47..5...
.76.....1
1.9...3.6
8.....75.
...4..28.
4...8261.
6.89.1...
